10
 . . . . . . . . . 
 . . . . . . . . . 
 . . . . . . . . . 
 . . . . . . . . . 
 . . . . . . . . . 
 . . . . . . . . . 
 . . . . . . . . . 
 .S. . . . . . . . 
S.W.S. . . . . . . 
 .S. . . . . . . . 
