10
--G.---.---.-GS.-GB.-GS.---.-BS.--P.--B
---.---.--S.--W.--P.--W.--S.--W.-BS.--B
---.--S.---.-SB.--B.--S.---.-SB.--P.--P
--S.--W.-SB.--P.--B.--B.--G.---.--B.--B
---.-SB.--W.-BS.--P.--P.-GB.---.---.---
--B.--P.GSB.--W.-BS.--B.---.--A.---.---
--G.-BS.--G.-GS.---.---.--S.---.---.---
--S.--W.--S.---.---.--S.--W.--S.---.--S
---.--S.---.---.---.--B.--P.--B.--S.--W
--S.--W.--S.---.--B.--P.--B.---.---.--S
