10
--.--.-S.--.--.-S.-W.-S.--.--
--.-S.-W.-S.-S.--.-S.--.-A.--
-G.--.-S.-S.-W.-S.--.--.-S.--
--.-G.--.--.-S.-W.-S.-S.-W.-S
--.--.--.-S.-W.GS.-W.GS.-S.--
--.--.--.--.-S.-S.-W.-S.-W.-S
--.--.--.--.--.--.-S.--.-S.-W
--.--.-G.--.--.--.--.--.-G.-S
-G.--.--.--.--.--.--.--.--.--
--.-G.--.--.--.-G.--.--.-G.--
