10
-.-.-.-.-.-.-.-.-.-
-.-.-.-.-.-.-.-.-.-
-.-.-.-.-.-.-.-.-.-
-.-.-.-.-.-.-.-.-.-
-.-.-.-.-.-.-.-.B.-
-.-.-.-.-.-.-.B.P.B
-.-.-.-.-.G.-.S.B.-
-.-.-.-.-.-.S.W.S.-
-.-.-.-.-.-.-.S.-.-
A.-.-.-.-.-.-.-.-.-
