10
--.--.--.--.--.--.--.--.--.--
--.--.--.--.--.--.--.--.--.--
--.--.--.--.--.--.--.--.--.--
--.--.--.--.--.--.--.--.--.--
--.--.--.--.--.--.--.--.--.--
--.--.-B.-B.-B.--.--.--.--.--
--.-B.-P.-P.-P.-B.--.--.--.--
--.-B.-P.GB.-P.-B.--.--.--.--
--.-B.-P.-P.-P.-B.--.--.--.--
-A.--.-B.-B.-B.--.--.--.--.--
