10
G.G.-.-.G.-.G.G.-.-
G.-.-.-.G.G.-.G.-.G
-.A.-.-.G.G.G.-.-.G
-.-.G.G.G.G.G.G.G.G
-.-.G.-.-.G.-.G.G.-
-.-.G.G.G.-.-.G.G.G
G.-.G.-.G.-.G.G.-.G
-.-.G.G.-.G.-.G.G.-
G.G.G.-.-.-.-.G.-.-
-.-.-.-.G.-.-.G.-.G
