10
AS. S. G.  .  .  .  .  .  .  
 W. W. S.  .  .  .  .  .  .  
 W. S.  .  .  .  .  .  .  .  
 S.  .  .  .  .  .  .  .  .  
  .  .  .  .  .  .  .  .  .  
  .  .  .  .  .  .  .  .  .  
  .  .  .  .  .  .  .  .  .  
  .  .  .  .  .  .  .  .  .  
  .  .  .  .  .  .  .  .  .  
  .  .  .  .  .  .  .  .  .  
