10
 G. G.  . B. P. B.  .  .  .  
 G. G. S. B. P. B.  . G.  .  
  .SB. W.SB. P. B.  .  .  .  
 B. P.SB.  . B.  .  .  .  .  
 P. B.  .  .  .  .  .  .  .  
 B.  .  .  .  . B.  .  .  .  
  .  .  .  . B. P. B.  .  .  
  .  .  .  .  . B. G. B.  .  
  .  .  .  .  .  . B. P. B.  
 A.  .  .  .  .  .  . B.  .  
