10
-S.-W.-W.-W.-W.-W.-W.-W.-W.-W
--.-S.-S.-S.-S.-S.-S.-S.-S.-W
-S.-W.-W.-W.-W.-W.-W.-W.-S.-W
-S.-W.-S.-S.-S.-S.-S.-W.-S.-W
-S.-W.-S.-W.-W.-W.-S.-W.-S.-W
-S.-W.-S.-W.GS.-S.-S.-W.-S.-W
-S.-W.-S.-W.-W.-W.-W.-W.-S.-W
-S.-W.-S.-S.-S.-S.-S.-S.-S.-W
-S.-W.-W.-W.-W.-W.-W.-W.-W.-W
--.-S.-S.-S.-S.-S.-S.-S.-S.AS
